О товаре
Описание
Ознакомиться со всей книгой в электронном виде можно по ссылке https://disk.yandex.ru/i/XNi5WD6WzbfW8A Подарочное иллюстрированное издание отпечатано на матовой мелованной бумаге Омела с закладкой ляссе одного цвета с капталом.Война и мир Л. Н. Толстого справедливо считается величайшим эпическим произведением не только русской, но и всей европейской литературы нового времени.Иллюстрации к этому уникальному изданию были выполнены талантливыми художниками Александром Петровичем Апситом. Для широкого круга читателей.

Свернуть описание
Дополнительная информация
Вес товара с упаковкой (г)	2460 г
Высота предмета	24 см
Количество страниц	1120 шт.
Ширина предмета	17 см
Ширина упаковки	18 см
Высота упаковки	26 см
Длина упаковки	7 см
Серия	Библиотека мировой литературы
Иллюстратор	А. П. Апсит
Жанры/тематика	Коллекционирование
Год выпуска	2022
Наименование книги	Л.Н. Толстой. Война и мир. Роман-эпопея. Иллюстрированное издание с закладкой-ляссе.
Страна производства	Россия
Автор	Толстой Л. Н.
Обложка	твердый переплет с золотым тиснением
Языки	русский
Вид бумаги	мелованная матовая
Возрастные ограничения	10+
Комплектация	книга
Свернуть характеристики
Вся информация основывается на последних сведениях от производителя