О товаре
Описание
"Букварь" - обучающая книга для детей от известного логопеда-педагога со стажем более 30 лет Надежды Жуковой. Соответствует ФГОС. Кандидат педагогических наук успешно создала методику для быстрого освоения навыка чтения, которая заключается в изучении слогов, а не отдельно взятых букв. Она позволяет быстро научиться читать и легко перейти к письму. Благодаря удобному порядку изучения происходит формирование устойчивого интереса к процессу чтения. Все, кто когда-либо работал с ребенком по пособиям Надежды Жуковой, отмечают простоту подачи материала, легкость усвоения малышами и быструю обучаемость. На каждой странице даны комментарии и рекомендации для родителей. "Букварь" — пример классического учебного пособия, которое станет отличной подготовкой к школе и 1 классу. В нем сочетаются традиционная и оригинальная логопедические методики чтения по слогам, которые показали высокую эффективность. Теги книги: книги для детей, детские книги, надежда жукова, развивающие книги для детей, учимся читать, азбука, 1 сентября, подготовка к школе, первый класс, выпускной в детском саду, чтение по слогам, шамиль ахмадуллин, колесникова, узорова нефедова, елена ульева, женя кац, олеся жукова, развивашки.

Свернуть описание
Дополнительная информация
Ширина предмета	15 см
Обложка	твердая
Назначение подарка	для ребенка; дочери; сыну
Редакция	Эксмодетство
Языки	русский
Наименование книги	Букварь (по СанПин)
Вес товара с упаковкой (г)	305 г
Количество страниц	96 шт.
Повод	1 сентября; день рождения; новый год
Вид бумаги	офсетная
ISBN	978-5-04-096176-4
Возрастные ограничения	4 +; 5+; 6+
Год выпуска	2022
Иллюстратор	коллектив иллюстраторов
Жанры/тематика	Развитие речи; Развитие ребенка; Обучение чтению
Автор	Жукова Надежда Сергеевна
Страна производства	Россия
Серия	Логопед Надежда Жукова
Высота предмета	27 см
Длина упаковки	26 см
Высота упаковки	1 см
Ширина упаковки	19 см
Комплектация	книга -1 шт
Свернуть характеристики