О товаре
Описание
Лучшее фэнтези для детей! Финалист мифопоэтической премии "Девочка, которая не видела снов" от Сары Бет Дерст, не раз номинированной на премию Андрэ Нортона. Софи живет в красивом трехэтажном доме, но мало кто знает, что в подвале находится магазинчик ее родителей. В нем продаются чужие сны. Однажды приходит странный посетитель, охотник за кошмарами, после визита которого жизнь Софи переворачивается с ног на голову. Ей начинают приходить угрозы, а родители вовсе пропали! Связан ли с этими событиями таинственный гость? Как юной девочке в одиночку раскрыть эти непростые тайны? Это прекрасное фэнтези разбудит ваше воображение и перенесёт в удивительный мир сновидений. Здесь есть всё, что нужно хорошей книге для подростков: тайна, рассказ о дружбе и том, как важно верить в себя и свои силы. А ещё здесь обитает пушистый монстр с шестью щупальцами. Он отвечает за юмор, так что скучно точно не будет! Теги книги: книги для детей, книги для подростков, современная литература, фэнтези, фэнтези для подростков, фэнтези книги, фантастика книги, фантастика для детей, фантастика для подростков, эксмо книги, книги для детей 10 лет, Коралина, Ходячий Замок,.

Свернуть описание
Дополнительная информация
Вес товара с упаковкой (г)	468 г
Языки	русский
Переводчик	Рыбакова Елизавета Юрьевна
Год выпуска	2023
Жанры/тематика	Фантастика и фэнтези для детей; Книги для подростков; Приключенческая литература для детей
Редакция	Эксмодетство
Автор	Сара Бет Дёрст
Страна производства	Россия
Ширина предмета	14 см
ISBN	978-5-04-103207-4
Обложка	твердая
Количество страниц	352 шт.
Повод	день рождения; новый год; 8 марта
Иллюстратор	Тимофеева Виктория Валерьевна
Возрастные ограничения	12+
Вид бумаги	офсетная
Назначение подарка	для ребенка; сыну; дочери
Наименование книги	Девочка, которая не видела снов
Высота предмета	22 см
Серия	Детск. Фэнтези для подростков
Длина упаковки	22 см
Высота упаковки	3 см
Ширина упаковки	15 см
Комплектация	Книга - 1 шт
Свернуть характеристики